1111111111111111111111111111111
1E00000000000000000000000000001
1010010100100100010010010101111
10100100101011110000000C00C01C1
1P0000000C00C00C000000000000001
1111111111111111111111111111111
