1111111111111111111111111111111
1E00000000000000000000000001001
1010010100100100010010010101111
1010010000101111001110C00C01111
1P0000000C00C00C00000C100000C01
1111111111111111111111111111111
