11111
1P001
10111
1000A
10CE1
11111
