11111
1P1C1
101E1
10001
11001
11111
