11111
1P1C1
10101
10001
110E1
11111
