11111
1P0P1
10111
10001
100E1
11111
